############
#......#####
#..........#
#..######..#
#..........#
#.....@....#
#..........#
#...#####..#
#..........#
#####......#
#..........#
############