#...........#
#...####....#
#...........#
#.#########.#
#...........#
#...#.@.#...#
#...#...#...#
#...........#
##########..#
............#
....#######.#
............#