.............
.............
.............
..#########..
.............
....#.@.#....
....#...#....
.............
.#########...
.............
....#######..
.............